		名詞	
おつこう	お疲れさまです。コミュニケーション統括部 広報部 クリエイティブグループの長谷川です。	組織	
おせわよ	お世話になっております。横浜DeNAベイスターズ 長谷川です。	組織	
そうま	奏真	人名	
おつでざ	お疲れさまです。デザイン本部の長谷川です。	組織	
でな	DeNA	組織	
おせわは	お世話になっております。長谷川です。	名	
かぎ	∟	名	
ほんかん	本幹	名	
おつぱ	OZPA	名	
あいらぶ	I☆YOKOHAMA	名詞	
じーめーる	hase0023@gmail.com	固有名詞	
おせわで	お世話になっております。株式会社ディー・エヌ・エーの長谷川です。	名詞	
べいびあはうす	BAY BEER HOUSE	名詞	
たぐぼーと	TUGBOAT	名詞	
べいすたさい	港星祭	名詞	
よこはまちょうせん	横浜頂戦	名詞	
うろく	宇禄	固有名詞	
だいせいどう	大誓堂	名詞	
えぬけーびー	NKB Y's	固有名詞	
べいびあがーでん	BAYビアガーデン	名詞	
ｇｃｐ	グーチョキパー	組織	
よこはまだっしゅ	横浜奪首	名詞	
